%%%#%##e...#
#%##%#..#pp#
#%%%%%%..###
....##%.####
....##%##r##
r##.##%%#...
#e###re%.#e.
...###p%%%%#
##r...e##.%r
###.#####.%.
##.e..p#%#%#
r..#..##%%%#
