##r..#####%%
####.#r###%%
#.r#.#...#%.
#e#.e..#.%%#
p...#..##%##
#e##..#%#%e.
.....##%#%#r
r.##.##%%%##
..##r#X#%r##
#ep##..#%###
#...e..#%###
######.#%%##
