#####r.#####
####.#e####r
##%#%%%.ep#r
##%#%#%.#...
##%%%#%.....
##%%#%%.....
r###%%#r###p
..##%###%%##
..r#%%%%%###
##..e###e###
#pe.####r###
##....######
