.%%#%##e...#
#%##%#..#pp#
#%%%%%%..###
....##%.####
....##%##r##
r##.##%.#...
#e###%%..#e.
...###%%%%%#
##r...e##.%r
###.#####.%.
##.e..p#%#%#
r..#..##%%%#
