###p#%%%%%%%
r.#%%%#.###%
..%%##..rr##
##.%..e###.p
p#.%%#......
e###%p#.##e#
...e%.#.#..#
e###%......#
r#%%%...##.#
##%####.##..
#%%#..e.##.r
####r.######
