####.#r.#.p#
r###..#.#..#
.#..#.....##
..#...##..##
#.#...####r#
..#.#.e.r.e.
e...#.##..#.
%##.ep#pe.X.
%#%#####.##r
%%%%##...###
%#%#.##.####
%#%%%#######
