%%#.#.%##.##
%%#%%%%...##
%##%.##...##
%%%%#r.e..##
%#.###.##e.#
%%###p.p#..#
%%#..#.##..#
#%#..##r..##
#%%%%....e.r
..e#%...#..#
.#..%#####.#
e..r%%%%##.p
